drug-name	drug-type
氟化钠	A
单氟磷酸钠	A
奥拉氟	A
氟化亚锡	A
氟化钠，复方	A
过氧化氢	A
氯己定	A
两性霉素 B（庐山霉素）	A
聚诺昔林	A
多米芬	A
羟喹啉	A
新霉素	A
咪康唑	A
那他霉素	A
海克替啶	A
四环素	A
苯佐氯铵	A
替贝碘铵（碘硫苯卓铵）	A
美帕曲星	A
甲硝唑	A
克霉唑	A
过硼酸钠	A
金霉素	A
多西环素	A
米诺环素	A
曲安西龙	A
地塞米松	A
氢化可的松	A
泼尼松龙，复方	A
肾上腺素	A
苄达明	A
乙酰水杨酸	A
肾上腺酮	A
氨来呫诺	A
贝卡普勒明	A
碳酸镁	A
氧化镁	A
过氧化镁	A
氢氧化镁	A
硅酸镁	A
氢氧化铝	A
水合氢氧化铝	A
磷酸铝	A
碳酸二羟基铝钠	A
乙酰乙酸铝	A
谷氨醇铝	A
甘氨酸铝	A
碳酸钙	A
硅酸钙	A
普盐复方	A
镁加铝（氢氧化镁铝，水化铝酸镁）	A
铝镁加	A
铝碳酸镁	A
铝硅酸镁	A
镁加铝和排气药	A
普盐复方和排气药	A
西咪替丁（甲氰咪胍，甲腈咪胍，甲腈咪胺）	A
雷尼替丁	A
法莫替丁	A
尼扎替丁	A
尼培替丁	A
罗沙替丁	A
枸橼酸铋雷尼替丁	A
拉呋替丁	A
西咪替丁，复方	A
法莫替丁，复方	A
米索前列醇	A
恩前列素	A
奥美拉唑	A
泮托拉唑	A
兰索拉唑	A
雷贝拉唑	A
埃索美拉唑镁	A
奥美拉唑，阿莫西林和甲硝唑	A
兰索拉唑，四环素和甲硝唑	A
兰索拉唑，阿莫西林和甲硝唑	A
泮托拉唑，阿莫西林和克拉霉素	A
奥美拉唑，阿莫西林和克拉霉素	A
埃索美拉唑，阿莫西林和克拉霉素	A
兰索拉唑，阿莫西林和克拉霉素	A
甘珀酸（氢琥珀酸甘草次酸，生胃酮）	A
硫糖铝	A
哌仑西平	A
氯化甲基蛋氨酸锍盐（维生素U）	A
次枸橼酸铋	A
丙谷酰胺	A
吉法酯（合欢香叶酯）	A
硫糖肽	A
乙酰甘草亭酸铝	A
佐利米定	A
曲昔派特	A
次硝酸铋	A
海藻酸	A
甘珀酸，与非安定药的复方	A
甘珀酸，与安定药的复方	A
吉法酯，与安定药的复方	A
羟苄利明（羟苯环嘧）	A
卡米罗芬	A
美贝维林	A
曲美布汀	A
罗西维林	A
双环维林（双环胺）	A
双己维林	A
双苯美林	A
哌立度酯（二苯哌酯）	A
苯咯铵	A
格隆铵	A
奥芬铵	A
喷噻铵	A
丙胺太林	A
奥替溴铵	A
甲胺太林	A
曲地铵	A
异丙铵	A
己环铵	A
泊尔定	A
美喷酯	A
贝弗宁	A
哌喷酯	A
二苯马尼	A
(2-二苯甲氧乙基)二乙基甲基碘铵	A
替莫碘胺	A
吡芬溴铵	A
噻哌溴铵	A
苯维铵	A
奥芬溴铵，复方	A
二甲氨基丙基吩噻嗪	A
尼非他胺	A
苯酰胺桂胺	A
罂粟碱	A
屈他维林	A
莫沙维林	A
阿洛司琼	A
替加色罗	A
西兰司琼	A
芬哌丙烷	A
地索普明	A
氯苄沙明	A
匹维铵	A
非诺维林	A
依丹帕明	A
普罗沙唑	A
阿尔维林（乙双苯丙胺）	A
曲匹布通（舒胆通，胆灵）	A
异美汀（握克丁）	A
卡罗维林	A
间苯三酚	A
硅氧烷	A
三甲基二苯丙胺	A
阿尔维林复方	A
阿托品	A
莨菪碱（天仙子胺）	A
颠茄总生物碱	A
丁基莨菪胺	A
甲基阿托品	A
甲基莨菪胺	A
芬托铵	A
西托溴铵	A
异丙铵和精神抑制剂	A
克利铵和安定药	A
羟苄利明和安定药	A
奥替溴铵和安定药	A
格隆铵和精神抑制剂	A
贝弗宁和精神抑制剂	A
安布溴铵和精神抑制剂	A
二苯马尼和安定药	A
依美铵和精神抑制剂	A
丙胺太林和安定药	A
甲基莨菪胺和安定药	A
颠茄总生物碱和安定药	A
阿托品和安定药	A
甲基后阿托品和安定药	A
莨菪碱和安定药	A
托齐林和镇痛药	A
吡托非农和镇痛药	A
贝弗宁和镇痛药	A
环隆铵和镇痛药	A
卡米罗芬和镇痛药	A
曲司铵和镇痛药	A
替莫碘胺和镇痛药	A
丁基莨菪胺和镇痛药	A
甲氧氯普胺	A
西沙必利	A
多潘立酮（吗叮啉，胃得灵，氯哌酮）	A
溴必利	A
阿立必利	A
氯波必利	A
昂丹司琼	A
格拉司琼	A
托烷司琼	A
多拉司琼	A
帕洛诺司琼	A
莨菪胺	A
草酸铈	A
三氯叔丁醇	A
美托哌丙嗪	A
屈大麻酚	A
大麻隆	A
阿瑞吡坦	A
莨菪胺，复方	A
三氯叔丁醇，复方	A
鹅去氧胆酸	A
熊去氧胆酸	A
胆酸	A
羟甲烟胺	A
哌普唑林	A
羟甲香豆素	A
环丁酸醇	A
谷氨酸精氨酸	A
水飞蓟素（西利马林，奶蓟素）	A
西替沃酮	A
依泊二醇	A
氧代戊二酸瓜氨酸	A
噻二西酸精氨酸	A
甘草酸	A
液体石蜡	A
多库酯钠（磺琥辛酯钠）	A
液体石蜡，复方	A
双醋酚丁	A
比沙可啶	A
丹蒽醌	A
酚酞（非诺夫他林）	A
蓖麻油	A
番泻叶苷	A
波希鼠李皮	A
匹可硫酸钠（达可速发）	A
双酚沙丁	A
接触性轻泻药复方	A
带有颠茄生物碱的接触性轻泻药复方	A
比沙可啶，复方	A
丹蒽醌，复方	A
番泻叶苷，复方	A
波希鼠李皮，复方	A
匹可硫酸钠，复方	A
卵叶车前子	A
羟乙基纤维素乙基醚	A
梧桐子	A
亚麻子	A
甲基纤维素	A
小麦	A
聚卡波非钙	A
卵叶车前子，复方	A
梧桐子，复方	A
亚麻子，复方	A
硫酸镁	A
无机盐复方	A
乳果糖	A
拉克替醇	A
硫酸钠	A
季戊四醇	A
聚乙二醇	A
甘露醇	A
磷酸钠	A
山梨醇（山梨糖醇）	A
枸橼酸镁	A
酒石酸钠	A
乳果糖，复方	A
聚乙二醇，复方	A
丹蒽醌，含其复方	A
甘油	A
油	A
多库酯钠（磺琥辛酯钠），含其复方	A
硫酸月桂酯，含其复方	A
溴化甲基纳曲酮	A
爱维莫潘	A
产生二氧化碳的药	A
鲁比前列酮	A
利那洛肽	A
普卡必利	A
制霉素（制霉菌素）	A
链霉素	A
多粘菌素B	A
巴龙霉素	A
两性霉素B（庐山霉素）	A
卡那霉素	A
万古霉素	A
多粘菌素	A
利福昔明	A
非达霉素	A
新霉素复方	A
链霉素复方	A
酞磺胺噻唑	A
磺胺胍	A
琥珀磺胺噻唑	A
溴羟喹啉	A
乙酰胂胺（阿西塔胂）	A
硝呋齐特	A
硝呋肼	A
药用活性炭	A
药用活性炭，复方	A
果胶	A
高岭土	A
交聚维酮	A
活性白土	A
天然硅酸铝	A
活性白土，复方	A
地芬诺酯（苯乙哌啶）	A
阿片	A
洛哌丁胺	A
地芬诺辛	A
氧洛哌丁胺	A
吗啡复方	A
洛哌丁胺，复方	A
泼尼松龙	A
泼尼松（强的松，去氢可的松）	A
倍他米松	A
替可的松	A
布地奈德	A
倍氯米松	A
色甘酸	A
柳氮磺吡啶	A
美沙拉秦（5-氨基水杨酸）	A
奥沙拉秦	A
巴柳氮	A
产生乳酸的微生物	A
Boulardii酵母菌	A
产生乳酸的微生物，复方	A
鞣酸蛋白	A
长角豆	A
钙化合物	A
消旋卡多曲	A
鞣酸蛋白复方	A
芬特明（苯丁胺）	A
芬氟拉明（氟苯丙胺）	A
安非拉酮	A
右芬氟拉明	A
马吲哚（氯苯咪吲哚）	A
乙非他明	A
去甲伪麻黄碱	A
氯苄雷司	A
美芬雷司	A
西布曲明	A
盐酸氯卡色林	A
麻黄碱复方	A
奥利司他	A
利莫那班	A
淀粉酶	A
多酶(脂肪酶、蛋白酶等)	A
胃蛋白酶	A
半乳糖苷酶	A
谷氨酸盐酸盐	A
甜菜碱盐酸盐	A
盐酸	A
柠檬酸	A
胃蛋白酶和酸制剂	A
多酶和酸制剂	A
人胰岛素	A
牛胰岛素	A
猪胰岛素	A
赖脯胰岛素	A
门冬胰岛素	A
赖谷胰岛素	A
甘精胰岛素	A
地特胰岛素	A
苯乙双胍	A
二甲双胍	A
丁福明	A
格列本脲	A
氯磺丙脲	A
甲磺丁脲	A
格列波脲	A
妥拉磺脲	A
氨磺丁脲	A
格列吡嗪	A
格列喹酮	A
格列齐特	A
美他己脲	A
格列派特	A
格列美脲	A
醋酸己脲	A
格列嘧啶	A
苯乙双胍和磺胺类	A
二甲双胍和磺胺类	A
二甲双胍和罗格列酮	A
格列美脲和罗格列酮	A
二甲双胍和吡格列酮	A
格列美脲和吡格列酮	A
二甲双胍和西格列汀	A
二甲双胍和维格列汀	A
匹格列酮/西他列汀	A
甲福明（双甲胍、二甲双胍）/阿洛利停	A
二甲双胍/瑞格列奈	A
阿卡波糖	A
米格列醇	A
伏格列波糖	A
曲格列酮	A
罗格列酮	A
吡格列酮	A
西他列汀	A
维格列汀	A
沙格列汀	A
西他列汀/辛伐他汀	A
瓜耳树胶	A
瑞格列奈	A
那格列奈	A
艾塞那肽	A
普兰林肽	A
苯氟雷司	A
利拉鲁肽	A
米格列奈	A
利西拉来	A
托瑞司他	A
多种维生素和铁	A
多种维生素和钙	A
多种维生素和其它矿物质，含复方	A
多种维生素和微量元素	A
视黄醇（维生素A）	A
β-胡萝卜素	A
麦角骨化醇	A
双氢速甾醇	A
阿法骨化醇	A
骨化三醇	A
胆骨化醇	A
骨化二醇	A
硫胺（维生素B1）	A
舒布硫胺	A
苯磷硫胺	A
抗坏血酸（维生素C）	A
抗坏血酸（维生素C）和钙的复方	A
烟酰胺（维生素B3）	A
吡哆醇（维生素B6）	A
生育酚（维生素E）	A
核黄素（维生素B2）	A
生物素（维生素B7，维生素H）	A
磷酸吡哆醛	A
肌醇	A
托可索仑	A
右泛醇	A
泛酸钙	A
泛硫乙胺	A
磷酸钙	A
葡乳醛酸钙	A
葡萄糖酸钙	A
乳酸钙	A
葡乳糖酸钙	A
氯化钙	A
甘油磷酸钙	A
枸橼酸钙赖氨酸复合物	A
葡庚糖酸钙	A
潘氨酸钙	A
无水醋酸钙	A
各种钙盐的复方	A
乙酰丙酸钙	A
氯化钾	A
枸橼酸钾	A
酒石酸氢钾	A
碳酸氢钾	A
葡萄糖酸钾	A
氯化钾复方	A
氯化钠	A
硫酸锌	A
葡萄糖酸锌	A
锌蛋白复合物	A
氯化镁	A
葡萄糖酸镁	A
门冬氨酸镁	A
乳酸镁	A
乙酰丙酸镁	A
氧代脯氨酸镁	A
乳清酸镁	A
各种镁盐的复方	A
氟化物复方	A
硒酸纳	A
亚硒酸纳	A
雄诺龙（雄甾烷醇酮）	A
司坦唑醇	A
美雄酮（去氢甲睾酮）	A
美替诺龙	A
羟甲烯龙	A
奎勃龙	A
普拉睾酮	A
氧雄龙	A
诺乙雄龙	A
诺龙	A
乙雌烯醇	A
环戊丙羟勃龙	A
左卡尼汀	A
腺苷蛋氨酸	A
谷酰胺	A
巯乙胺	A
卡谷氨酸	A
甜菜碱	A
阿糖苷酶（阿糖脑苷脂酶）	A
伊米苷酶	A
α-半乳糖苷酶	A
β-半乳糖苷酶	A
粘多糖-L-艾杜糖醛酸水解酶	A
沙克罗酶	A
α-葡萄糖苷酶	A
加硫酶	A
艾杜硫酶	A
α-硫辛酸	A
茴三硫	A
苯基丁酸钠	A
尼替西农	A
醋酸锌	A
米格鲁特	A
沙丙蝶呤	A
HPN-100	A
双香豆素	B
苯茚二酮	B
华法林	B
苯丙香豆素	B
醋硝香豆素	B
双香豆乙酯	B
氯茚二酮	B
二苯茚酮	B
噻氯香豆素	B
肝素	B
抗凝血酶 III	B
达肝素	B
依诺肝素	B
那屈肝素	B
帕那肝素	B
瑞肝素	B
达那肝素	B
亭扎肝素	B
硫酸氨基脱氧葡聚糖	B
倍米肝素	B
肝素,复方	B
地他唑	B
氯克罗孟	B
吡考米特	B
氯吡格雷	B
噻氯匹定	B
双嘧达莫	B
卡巴匹林钙	B
依前列醇	B
吲哚布芬	B
伊洛前列素	B
阿昔单抗	B
阿洛普令	B
埃替巴肽	B
替罗非班	B
三氟柳	B
贝前列素	B
曲前列环素	B
普拉格雷	B
链激酶	B
阿替普酶	B
阿尼普酶	B
尿激酶	B
纤维蛋白溶酶	B
纤维蛋白酶	B
瑞替普酶	B
沙芦普酶	B
安克洛酶	B
重组人活化C蛋白	B
替奈普酶	B
丙种蛋白	B
地西卢定	B
来匹卢定	B
阿加曲班	B
美加群	B
西美加群	B
比伐卢定	B
达比加群酯	B
利伐沙班	B
阿哌沙班	B
去纤苷	B
硫酸软骨素	B
磺达肝素	B
氨基己酸	B
氨甲环酸	B
氨甲苯酸	B
抑肽酶	B
α1-抗胰蛋白酶	B
C1-抑制剂	B
卡莫司他	B
植物甲萘醌（维生素K1）	B
甲萘醌（维生素K3）	B
人纤维蛋白原	B
可吸收的明胶海绵	B
氧化纤维素	B
四半乳糖醛酸羟甲酯	B
凝血酶	B
胶原	B
海藻酸钙	B
在复方中的凝血因子Ⅸ, II, Ⅶ 和 Ⅹ	B
凝血因子Ⅷ	B
凝血因子Ⅷ抑制剂	B
凝血因子Ⅸ	B
凝血因子Ⅶ	B
维勒布兰德氏因子和凝血因子Ⅷ的复方	B
依他凝血素α	B
诺那凝血素α	B
酚磺乙胺（止血敏）	B
卡巴克络（安络血，肾上腺色素缩氨脲）	B
巴曲酶	B
罗米司亭	B
艾曲波帕	B
硫酸甘氨酸亚铁	B
富马酸亚铁	B
葡萄糖酸亚铁	B
碳酸亚铁	B
氯化亚铁	B
琥珀酸亚铁	B
硫酸亚铁	B
酒石酸亚铁	B
门冬氨酸亚铁	B
抗坏血酸亚铁	B
碘化亚铁	B
枸橼酸铁钠	B
含糖氧化铁	B
铁依地酸钠	B
氢氧化铁	B
糊精铁	B
枸橼酸铁	B
硫酸软骨素-铁络合物	B
乙酰转铁蛋白铁	B
蛋白琥珀酰铁	B
山梨醇-枸橼酸-铁络合物	B
山梨醇-葡萄糖酸-铁络合物	B
葡聚糖-铁络合物	B
葡萄糖酸钠-铁络合物	B
氨基酸亚铁络合物	B
铁、维生素B12和叶酸	B
铁、多种维生素和叶酸	B
铁和多种维生素	B
铁、多种维生素和矿物质	B
其它复方	B
氰钴胺	B
氰钴胺鞣酸复合物	B
羟钴胺	B
腺苷钴胺	B
甲钴胺(弥可保)	B
氰钴胺复方	B
羟钴胺复方	B
叶酸	B
叶酸复方	B
阿法依泊汀	B
阿法达依泊汀	B
甲氧基聚乙二醇化阿法依伯汀	B
白蛋白	B
其它血浆蛋白成分	B
氟烃类血液代用品	B
右旋糖酐	B
明胶	B
羟乙基淀粉	B
血红蛋白 crosfumaril	B
血红蛋白 raffimer	B
血红蛋白谷氨酸基团（牛）	B
红细胞	B
血小板	B
血浆	B
脐血干细胞	B
氨基酸	B
脂肪乳	B
碳水化合物	B
蛋白水解物	B
电解质	B
电解质和碳水化合物	B
氨丁三醇（缓血酸胺）	B
电解质与其它药物的复方	B
尿素	B
西吡铵	B
呋喃西林	B
磺胺甲二唑	B
牛磺罗定（滔罗定）	B
扁桃酸	B
诺昔硫脲	B
乳酸依沙吖啶	B
枸橼酸钠	B
碳酸氢钠	B
葡萄糖	B
山梨醇	B
甘氨酸	B
氯化铵	B
磷酸钾，含与其他钾盐的复方	B
醋酸钠	B
磷酸镁	B
氯化锌	B
甘油磷酸钠	B
乳酸钾	B
心麻痹治疗溶液	B
醋酸钾	B
复方电解质	B
盐酸精氨酸	B
丙氨酰谷酰胺	B
赖氨酸	B
氨丁三醇	B
纤维蛋白溶酶和脱氧核糖核酸酶	B
透明质酸酶	B
胰凝乳蛋白酶	B
胰蛋白酶	B
脱氧核糖核酸酶	B
菠萝蛋白酶	B
链激酶复方	B
正铁血红素	B
乙酰洋地黄毒苷	C
乙酰地高辛	C
洋地黄叶	C
洋地黄毒苷（狄吉妥辛）	C
地高辛（地谷新，异羟洋地黄毒苷）	C
毛花苷C（毛花洋地黄苷C，西地兰）	C
去乙酰毛花苷	C
甲地高辛	C
吉妥福酯	C
乙酰地高辛复方	C
海葱次苷（前海葱苷原，海葱次苷甲）	C
海葱次苷复方	C
G-毒毛旋花苷	C
磁麻苷	C
黄夹次苷	C
奎尼丁	C
普鲁卡因胺	C
丙吡胺（双异丙吡胺，异脉停，诺培心，达舒平）	C
司巴丁	C
阿义马林（阿吗灵，西萝芙木碱）	C
普拉马林	C
劳拉义明	C
奎尼丁与非安定药的复方	C
奎尼丁与安定药的复方	C
利多卡因（赛罗卡因）	C
美西律（慢心利，脉律定）	C
妥卡尼（妥卡胺）	C
阿普林定（安搏律定）	C
普罗帕酮（普鲁帕酮）	C
氟卡尼	C
劳卡尼（氯克律，洛卡尼啶）	C
恩卡尼	C
乙沙西嗪	C
胺碘酮（乙胺碘呋酮，胺碘达隆，安律酮）	C
托西溴苄铵	C
丁萘夫汀	C
多非利特	C
伊布利特	C
替地沙米	C
莫雷西嗪	C
西苯唑啉	C
依替福林	C
异丙肾上腺素（喘息定）	C
去甲肾上腺素	C
多巴胺	C
去甲苯福林	C
去氧肾上腺素	C
多巴酚丁胺	C
奥昔君	C
间羟胺（阿拉明）	C
甲氧明（美速克新命，甲氧胺）	C
美芬丁胺	C
二甲福林	C
普瑞特罗	C
多培沙明	C
吉培福林	C
异波帕胺（多巴胺异酯）	C
米多君	C
奥克巴胺（去甲新福林，章鱼胺）	C
非诺多泮	C
咖啡君（咖啡麻黄碱，去甲麻黄茶碱）	C
阿布他明	C
茶碱那林（去甲肾上腺素茶碱）	C
依替福林复方	C
氨力农（氨联吡啶酮，氨利酮）	C
米力农	C
依诺昔酮	C
布拉地新	C
血管紧张素胺（增血压素）	C
扎莫特罗	C
左西孟旦	C
硝酸甘油（三硝酸甘油酯）	C
二硝酸甲基丙基丙二醇酯	C
戊四硝酯	C
丙帕硝酯（硝二羟甲丁醇）	C
二硝酸异山梨酯（硝异梨醇，消心痛）	C
三乙硝胺（三硝乙醇胺）	C
赤藓醇四硝酸酯	C
单硝酸异山梨酯	C
复方中的有机硝酸酯	C
替尼曲明	C
三硝酸甘油酯，复方	C
二硝酸甲基丙基丙二醇酯，复方	C
戊四硝酯，复方	C
丙帕硝酯，复方	C
二硝酸异山梨酯，复方	C
三乙硝胺，复方	C
赤藓醇四硝酸酯，复方	C
在与安定药的复方中的有机硝酸酯	C
氟司喹南	C
托西硝乙胺	C
普尼拉明	C
奥昔非君（麻黄苯丙酮）	C
苯碘达隆（碘苯呋酮）	C
卡波罗孟（延心痛）	C
海索苯定	C
依他苯酮（乙胺苯丙酮）	C
辛胺醇（氨甲庚醇）	C
伊莫拉明	C
地拉卓（克冠二氮卓）	C
曲匹地尔	C
吗多明（脉心导敏，吗导敏）	C
乙氧黄酮	C
桂哌酯	C
氯达香豆素	C
尼可地尔	C
林西多明	C
奈西立肽	C
托西硝乙胺，复方	C
普尼拉明，复方	C
奥昔非君，复方	C
苯碘达隆，复方	C
前列地尔	C
樟脑	C
吲哚美辛	C
山楂苷	C
肉醇磷酯	C
磷肌酸	C
二磷酸果糖	C
泛癸利酮（癸烯醌,辅酶Q10）	C
腺苷	C
替拉西嗪	C
阿卡地新	C
曲美他嗪（三甲氧苄嗪）	C
布洛芬	C
伊伐雷定	C
雷诺嗪	C
艾卡替班	C
米屈肼	C
瑞西那明	C
利舍平（利血平）	C
蛇根木生物碱复方	C
蛇根木生物碱,全根	C
地舍平（去甲氧利血平）	C
美索舍平	C
比他舍平	C
利舍平复方	C
比他舍平复方	C
甲基左旋多巴	C
甲基多巴（消旋）	C
可乐定（可乐宁，血压得平，氯压平，可乐亭）	C
胍法辛	C
托洛尼定	C
莫索尼定	C
利美尼定	C
樟磺咪芬	C
美卡拉明（梅坎米胺，四甲双环庚胺）	C
哌唑嗪（脉宁平）	C
吲哚拉明（吲哚哌胺）	C
曲马唑嗪	C
多沙唑嗪	C
乌拉地尔	C
倍他尼定（二甲苄胍）	C
胍乙啶	C
胍生	C
异喹胍（胍喹定）	C
胍氯酚	C
胍那佐定	C
胍诺沙苄（胍羟苯）	C
二氮嗪（氯甲苯噻嗪）	C
双肼屈嗪（双肼苯哒嗪，利普索）	C
肼屈嗪（肼酞嗪，肼苯哒嗪）	C
恩屈嗪	C
卡屈嗪	C
米诺地尔（长压定，敏乐定）	C
硝普盐	C
吡那地尔	C
藜芦	C
甲酪氨酸	C
帕吉林（优降宁）	C
酮色林	C
波生坦	C
安利生坦	C
西他生坦	C
利舍平和利尿药	C
瑞西那明和利尿药	C
地舍平和利尿药	C
美索舍平和利尿药	C
比他舍平和利尿药	C
蛇根木生物碱,全根和利尿药	C
昔洛舍平和利尿药	C
蛇根木生物碱和利尿药的复方,含其它复方	C
利舍平和利尿药以及其它药物的复方	C
瑞西那明和利尿药以及其它药物的复方	C
利舍平和利尿药以及与安定药的复方	C
甲基左旋多巴和利尿药	C
可乐定和利尿药	C
莫索尼定和利尿药	C
可乐定和利尿药以及其它药物的复方	C
哌唑嗪和利尿药	C
胍乙啶和利尿药	C
双肼屈嗪和利尿药	C
肼屈嗪和利尿药	C
吡考屈嗪和利尿药	C
双肼屈嗪和利尿药以及其它药物的复方	C
吡考屈嗪和利尿药以及安定药的复方	C
藜芦和利尿药	C
帕吉林和利尿药	C
吡那地尔和利尿药	C
苄氟噻嗪	C
氢氟噻嗪	C
氢氯噻嗪	C
氯噻嗪（克尿塞，氯噻，克尿噻）	C
泊利噻嗪（多噻嗪）	C
三氯噻嗪（三氯甲噻嗪）	C
环戊噻嗪（环戊氯噻嗪）	C
甲氯噻嗪	C
环噻嗪	C
美布噻嗪	C
苄氟噻嗪和钾	C
氢氟噻嗪和钾	C
氢氯噻嗪和钾	C
氯噻嗪和钾	C
泊利噻嗪和钾	C
三氯噻嗪和钾	C
环戊噻嗪和钾	C
甲氯噻嗪和钾	C
环噻嗪和钾	C
氯噻嗪复方	C
氢氟噻嗪复方	C
喹乙宗	C
氯帕胺（氯哌胺）	C
氯噻酮	C
美夫西特	C
氯非那胺	C
美托拉宗	C
美替克仑	C
希帕胺	C
吲达帕胺（稳定血压灵，寿比山，茚磺苯酰）	C
氯索隆	C
芬喹唑	C
氯索隆与安定药的复方	C
喹乙宗和钾	C
氯帕胺和钾	C
氯噻酮和钾	C
美夫西特和钾	C
氯非那胺和钾	C
汞撒利	C
可可碱	C
西氯他宁	C
呋塞米	C
布美他尼（丁尿胺，丁苯氧酸）	C
吡咯他尼	C
托拉塞米	C
呋塞米和钾	C
布美他尼和钾	C
依他尼酸（利尿酸）	C
替尼酸	C
莫唑胺	C
地西唑林	C
螺内酯（安体舒通，螺旋内酯甾酮）	C
坎利酸钾	C
坎利酮	C
依普利酮	C
阿米洛利（氨氯吡脒）	C
氨苯喋啶	C
氢氯噻嗪和保钾药的复方	C
三氯噻嗪和保钾药的复方	C
依匹噻嗪和保钾药的复方	C
阿尔噻嗪和保钾药的复方	C
美布噻嗪和保钾药的复方	C
氯噻酮和保钾药的复方	C
环戊噻嗪和保钾药的复方	C
美托拉宗和保钾药的复方	C
苄氟噻嗪和保钾药的复方	C
布噻嗪和保钾药的复方	C
呋塞米和保钾药的复方	C
布美他尼和保钾药的复方	C
替伐普坦	C
康伐普坦	C
异克舒令（苯氧丙酚胺）	C
布酚宁（苯丙酚胺）	C
巴美生	C
酚妥拉明	C
妥拉唑啉	C
烟酸	C
烟醇	C
烟酸肌醇	C
环烟酯	C
喷替茶碱（己可可碱）	C
尼可占替诺	C
己酮可可碱	C
烟酸乙羟茶碱	C
二氢麦角毒甲磺酸盐	C
尼麦角林（麦角溴烟酯，瑟米恩）	C
双氢麦角汀	C
二氢麦角毒甲磺酸盐复方	C
双氢麦角汀复方	C
血管舒缓素	C
环扁桃酯（安替心，安脉生，舒心乐）	C
酚苄明（苯氧苄胺）	C
长春胺（长春蔓胺，长春花碱）	C
莫西赛利	C
苄环烷	C
长春布宁	C
舒考地尔	C
丁咯地尔	C
萘呋胺	C
布他拉胺（噁唑啉丁胺）	C
维司那定（氢吡豆素）	C
西替地尔（环己噻卓酯）	C
桂哌齐特	C
艾芬地尔	C
阿扎培汀（氮佩汀）	C
法舒地尔	C
氟米龙（氟甲松龙）	C
氟可龙	C
氟轻松（氟西奈德）	C
醋酸氟轻松（氟新诺龙酯）	C
丁卡因	C
苯佐卡因	C
辛可卡因（沙夫卡因）	C
普鲁卡因（奴弗卡因）	C
奥昔卡因	C
普莫卡因（普拉莫星）	C
硝酸甘油	C
硝酸异山梨酯	C
铝制剂	C
铋制剂复方	C
其它制剂复方	C
锌制剂	C
三苄糖苷	C
有机类肝素	C
阿朴酸钠	C
木聚硫钠	C
类肝素，复方	C
肝素复方	C
油酸单乙醇胺	C
聚桂醇400	C
转化糖	C
十四烷硫酸钠	C
苯酚	C
葡萄糖，复方	C
羟苯磺酸钙	C
羟苯磺酸钙，复方	C
乙吗芦丁	C
莫诺芦丁（单羟乙基芦丁）	C
地奥司明	C
曲克芦丁（三羟乙基芦丁）	C
海曲司明	C
乙吗芦丁，复方	C
地奥司明，复方	C
曲克芦丁复方	C
阿普洛尔（心得舒，烯丙心安）	C
氧烯洛尔（心得平，烯丙氧心安）	C
吲哚洛尔（吲哚心安，心得静，心得乐）	C
普萘洛尔	C
噻吗洛尔	C
索他洛尔	C
纳多洛尔（萘多醇，康加尔多）	C
甲吲洛尔（甲吲哚心安）	C
卡替洛尔	C
特他洛尔	C
波吲洛尔	C
布拉洛尔（氯甲苯心安）	C
喷布洛尔	C
氯拉洛尔	C
索他洛尔复方	C
普拉洛尔	C
美托洛尔	C
阿替洛尔	C
醋丁洛尔	C
倍他洛尔	C
贝凡洛尔	C
比索洛尔	C
塞利洛尔	C
艾司洛尔	C
依泮洛尔	C
S-阿替洛尔	C
奈必洛尔	C
他林洛尔	C
美托洛尔复方	C
比索洛尔，复方	C
拉贝洛尔（柳胺苄心定）	C
卡维地洛	C
氧烯洛尔和噻嗪类利尿药	C
普萘洛尔和噻嗪类利尿药	C
噻吗洛尔和噻嗪类利尿药	C
索他洛尔和噻嗪类利尿药	C
纳多洛尔和噻嗪类利尿药	C
美替洛尔和噻嗪类利尿药	C
美托洛尔和噻嗪类利尿药	C
阿替洛尔和噻嗪类利尿药	C
醋丁洛尔和噻嗪类利尿药	C
贝凡洛尔和噻嗪类利尿药	C
比索洛尔和噻嗪类利尿药	C
美托洛尔和噻嗪类利尿药,复方	C
拉贝洛尔和噻嗪类利尿药	C
氧烯洛尔和其它利尿药的复方	C
吲哚洛尔和其它利尿药的复方	C
波吲洛尔和其它利尿药的复方	C
喷布洛尔和其它利尿药的复方	C
美托洛尔和其它利尿药的复方	C
阿替洛尔和其它利尿药的复方	C
S-阿替洛尔和其它利尿药，复方	C
拉贝洛尔与其它利尿药的复方	C
噻吗洛尔、噻嗪类利尿药和其它利尿药的复方	C
阿替洛尔、噻嗪类利尿药和其它利尿药的复方	C
普萘洛尔和其它抗高血压药	C
美托洛尔和其它抗高血压药	C
阿替洛尔和其它抗高血压药	C
氨氯地平	C
非洛地平	C
伊拉地平	C
尼卡地平	C
硝苯地平（硝苯啶，硝苯吡啶，利心平）	C
尼莫地平	C
尼索地平	C
尼群地平（硝基乙吡啶）	C
拉西地平	C
尼伐地平	C
马尼地平	C
巴尼地平	C
乐卡地平	C
西尼地平	C
贝尼地平	C
硝苯地平，复方	C
米贝拉地尔	C
维拉帕米	C
戈洛帕米	C
维拉帕米，复方	C
地尔硫卓	C
芬地林（苯乙二苯丙胺）	C
苄普地尔	C
利多氟嗪	C
哌克昔林（双环己哌啶，心舒宁）	C
硝苯地平和利尿药	C
氨氯地平/利尿剂	C
卡托普利	C
依那普利	C
赖诺普利	C
培哚普利	C
雷米普利	C
喹那普利	C
贝那普利	C
西拉普利	C
福辛普利	C
群多普利	C
螺普利	C
地拉普利	C
莫昔普利	C
替莫普利	C
佐芬普利	C
咪达普利	C
卡托普利和利尿药	C
依那普利和利尿药	C
赖诺普利和利尿药	C
培哚普利和利尿药	C
雷米普利和利尿药	C
喹那普利和利尿药	C
贝那普利和利尿药	C
西拉普利和利尿药	C
福辛普利和利尿药	C
地拉普利和利尿药	C
莫昔普利和利尿药	C
佐芬普利和利尿药	C
依那普利和乐卡地平	C
赖诺普利和氨氯地平	C
培哚普利和氨氯地平	C
雷米普利和非洛地平	C
群多普利和维拉帕米	C
地拉普利和马尼地平	C
培多普利/氨氯地平/吲哒帕胺	C
氯沙坦	C
依普罗沙坦	C
缬沙坦	C
厄贝沙坦	C
他索沙坦	C
坎地沙坦	C
替米沙坦	C
奥美沙坦美索酯	C
氯沙坦和利尿药	C
依普罗沙坦和利尿药	C
缬沙坦和利尿药	C
厄贝沙坦和利尿药	C
坎地沙坦和利尿药	C
替米沙坦和利尿药	C
奥美沙坦美索酯和利尿药	C
缬沙坦和氨氯地平	C
奥美沙坦酯和氨氯地平	C
替米沙坦和氨氯地平	C
坎地沙坦/氨氯地平	C
缬沙坦，氨氯地平和氢氯噻嗪	C
缬沙坦和阿利克仑	C
瑞米吉仑	C
阿利吉仑	C
阿利吉仑和氢氯噻嗪	C
辛伐他汀	C
洛伐他汀	C
普伐他汀	C
氟伐他汀	C
阿伐他汀	C
西立伐他汀	C
罗舒伐他汀	C
匹伐他汀	C
氯贝丁酯	C
苯扎贝特	C
氯贝酸铝	C
吉非贝齐	C
非诺贝特	C
双贝特	C
氯烟贝特	C
环丙贝特	C
依托贝特	C
氯贝胺	C
考来烯胺	C
考来替泊	C
考来糖酐	C
考来维仑	C
戊四烟酯（烟酸戊四醇酯）	C
尼可呋糖（烟呋糖酯）	C
烟酸铝	C
阿昔莫司	C
烟酸，复方	C
右甲状腺素	C
普罗布考（普罗布可，丙丁酚）	C
硫地醇	C
美格鲁托	C
ω-3-甘油三酸酯，含其它酯和酸	C
5'-磷酸吡哆醛谷氨酸镁	C
甘蔗原素	C
依泽替麦	C
洛伐他汀和烟酸	C
辛伐他汀和依折麦布	C
普伐他汀和非诺贝特	C
辛伐他汀/菲诺贝特	C
阿托伐他汀/依替米贝	C
瑞舒伐他汀/依替米贝	C
辛伐他汀和乙酰水杨酸	C
普伐他汀和乙酰水杨酸	C
阿托伐他汀和氨氯地平	C
瑞舒伐他汀/水杨酸	C
曲古霉素	D
培西洛星	D
吡咯尼群（皮硝菌素，硝吡咯菌素）	D
灰黄霉素	D
益康唑	D
氯咪达唑	D
异康唑	D
噻苯达唑	D
噻康唑	D
酮康唑	D
硫康唑	D
联苯苄唑	D
奥昔康唑	D
芬替康唑	D
奥莫康唑	D
舍他康唑	D
氟康唑	D
氟曲马唑	D
依柏康唑	D
咪康唑复方	D
联苯苄唑复方	D
溴氯水杨酸苯胺	D
甲品红	D
三溴间甲酚	D
十一烯酸	D
2-(4-氯苯氧基)乙醇	D
氯苯甘醚	D
替克拉酮	D
舒苯汀	D
羟苯乙酯	D
卤普罗近	D
水杨酸	D
二硫化硒	D
环吡酮	D
特比萘芬	D
阿莫罗芬	D
地马唑	D
托萘酯	D
托西拉酯	D
氟胞嘧啶	D
萘替芬	D
布替萘芬	D
十一烯酸,复方	D
尿素复方	D
氨苯甲酸	D
辛诺沙酯	D
倍他胡萝卜素	D
卡地姆碘	D
聚糖酐	D
透明质酸	D
克立诺姆	D
甘草次酸	D
胶原酶	D
胶原酶，复方	D
松齐拉敏	D
美吡拉敏（美吡拉明，新安替根）	D
西那利定	D
曲吡那敏	D
氯吡拉敏（氯吡胺，卤吡胺）	D
异丙嗪	D
托普帕敏	D
二甲茚定	D
氯马斯汀（铁线莲亭）	D
巴米品	D
异西喷地	D
苯海拉明	D
甲溴苯海拉明	D
氯苯沙明（氯苯氧胺，氯甲苯海拉明）	D
奥布卡因（氨布卡因）	D
奎尼卡因	D
地蒽酚	D
地蒽酚复方	D
三甲沙林	D
甲氧沙林（敏白灵，甲氧呋豆素）	D
富马酸	D
卡泊三醇（钙泊三醇）	D
他卡西醇	D
他扎罗汀	D
卡泊三醇复方	D
香柑油内酯	D
阿维A酯（依曲昔酯，维甲灵，替维甲，苯壬四烯酯，银屑灵）	D
阿维A酸	D
富马酸衍生物，复方	D
地美环素	D
土霉素	D
夫西地酸	D
氯霉素	D
杆菌肽	D
庆大霉素	D
短杆菌素	D
莫匹罗星	D
维吉霉素	D
阿米卡星	D
瑞他莫林	D
磺胺嘧啶银	D
磺胺噻唑	D
磺胺米隆	D
磺胺美唑	D
磺胺	D
磺胺甲嘧啶	D
磺胺嘧啶银，复方	D
碘苷	D
曲金刚胺	D
阿昔洛韦（无环鸟苷）	D
鬼臼毒素	D
肌苷	D
喷昔洛韦	D
溶菌酶	D
伊巴他滨	D
依度尿苷	D
咪喹莫特	D
多可沙诺（山嵛醇，二十二烷醇）	D
阿昔洛韦，复方	D
巨大戟醇甲基丁烯酸酯	D
甲泼尼龙（甲强龙）	D
氯倍他松	D
丁酸氢化可的松	D
氟米松	D
氟可丁	D
氟培龙	D
氟泼尼定	D
地奈德（丙缩强羟龙，羟泼尼缩松）	D
曲安西龙（去炎松）	D
阿氯米松	D
丙丁氢化可的松	D
氯可托龙	D
皮质甾体激素类，复方	D
氟氯洛龙	D
去羟米松（脱氧米松）	D
二氟可龙	D
氟氢缩松（丙酮缩氟氢羟龙）	D
二氟拉松	D
安西奈德（安西缩松）	D
卤米松	D
莫米松	D
醋丙甲泼尼龙	D
醋丙氢可的松	D
氟替卡松	D
泼尼卡酯	D
二氟泼尼酯（醋丁二氟龙）	D
卤倍他松	D
氯倍他索	D
哈西奈德（哈西缩松，氯氟舒松）	D
泼尼松龙和灭菌药的复方	D
氢化可的松和灭菌药的复方	D
氟米松和灭菌药的复方	D
地奈德和灭菌药的复方	D
曲安西龙和灭菌药的复方	D
丁酸氢化可的松和灭菌药的复方	D
倍他米松和灭菌药的复方	D
氟轻松和灭菌药的复方	D
氟可龙和灭菌药的复方	D
二氟可龙和灭菌药的复方	D
氢化可的松和抗生素的复方	D
甲泼尼龙和抗生素的复方	D
泼尼松龙和抗生素的复方	D
曲安西龙和抗生素的复方	D
氟泼尼定和抗生素的复方	D
氟米龙和抗生素的复方	D
地塞米松和抗生素的复方	D
氟米松和抗生素的复方	D
倍他米松和抗生素的复方	D
氟轻松和抗生素的复方	D
氟氢缩松和抗生素的复方	D
倍氯米松和抗生素的复方	D
醋酸氟轻松和抗生素的复方	D
氟可龙和抗生素的复方	D
氯倍他索和抗生素的复方	D
氟米龙	D
皮质甾体激素类的复方	D
去羟米松	D
氨吖啶	D
吖啶黄	D
双溴丙脒	D
普罗帕脒	D
己脒定	D
聚己缩胍	D
氯己定，复方	D
六氯酚	D
聚甲酚磺醛	D
三氯生	D
氯二甲酚	D
联苯酚	D
辛苯氧基聚乙二醇醚-碘	D
聚维酮碘	D
碘	D
二碘羟基丙烷	D
地喹铵	D
氯喹那多	D
氯碘羟喹	D
苯扎铵	D
西曲铵	D
西曲胺	D
二癸二甲氯铵	D
苄索氯铵	D
奥替尼啶，复方	D
苄索氯铵，复方	D
多地溴铵，复方	D
氨基汞化氯	D
硼酸苯汞	D
氯化汞	D
汞溴红	D
金属汞	D
硫柳汞	D
碘化汞	D
硝酸银	D
金属银	D
曙红（四溴荧光素）	D
丙醇	D
氯胺T钠	D
异丙醇	D
高锰酸钾	D
次氯酸钠	D
乙醇	D
丙醇，复方	D
新霉素B	D
硝酸苯汞	D
苯度铵	D
水合氯化铝	D
碘仿	D
无添加药物的锌绷带	D
添加药物的锌绷带	D
硫氯酚	D
硫磺	D
噻克索酮	D
甲硫芬	D
维A酸（维甲酸）	D
视黄醇（维生素A1）	D
阿达帕林	D
异维A酸	D
莫维A胺	D
维A酸，复方	D
阿达帕林，复方	D
异维A酸，复方	D
过氧化苯甲酰	D
过氧化苯甲酰，复方	D
克林霉素	D
红霉素	D
甲氯环素	D
克林霉素，复方	D
红霉素，复方	D
氯化铝	D
雷琐辛（间苯二酚）	D
壬二酸	D
氧化铝	D
氨苯砜	D
各种复方	D
ictasol 鱼石脂磺酸钠	D
钙化合物类	D
硒化合物类	D
硫化合物类	D
珍尼柳酯	D
他克莫司	D
吡美莫司	D
γ-亚麻酸	D
琥珀酸锂	D
对甲氧酚	D
替拉曲考	D
奥沙西罗	D
非那雄胺（非那甾胺）	D
氢醌	D
吡硫翁锌	D
莫诺苯宗（氢醌苄醚）	D
依氟鸟氨酸	D
双氯芬酸	D
阿利维A酸	D
γ-亚麻酸，复方	D
胶原，复方	D
克念菌素	G
卡非西林	G
喷他霉素	G
制霉素，复方	G
双碘喹啉（二碘羟基喹啉）	G
乳酸	G
醋酸	G
抗坏血酸	G
磺胺托拉米	G
磺胺类复方	G
奥硝唑	G
阿扎硝唑	G
普罗硝唑	G
布康唑	G
咪唑衍生物类的复方	G
特康唑	G
氯登妥因	G
硝呋太尔	G
呋喃唑酮	G
丙噻酯	G
酶乳杆菌	G
地衣酸铜	G
甲麦角新碱	G
麦角生物碱	G
麦角新碱	G
甲麦角新碱和缩宫素	G
地诺前列素	G
地诺前列酮	G
吉美前列素	G
卡前列素	G
硫前列酮	G
塑料宫内避孕器	G
带有铜的塑料宫内避孕器	G
带有孕激素的塑料宫内避孕器	G
带有孕激素和雌激素的阴道避孕环	G
利托君	G
非诺特罗（芬忒醇）	G
溴隐亭（2-溴麦角隐亭，溴麦角环肽）	G
麦角乙脲	G
卡麦角林	G
喹高利特	G
甲麦角林	G
特麦角脲	G
萘普生	G
氟诺洛芬	G
阿托西班	G
羊荆子	G
升麻	G
炔诺醇和炔雌醇	G
奎孕醇和炔雌醇	G
利奈孕酮（炔雌烯醇）和炔雌醇	G
甲地孕酮和雌激素	G
炔诺酮和炔雌醇	G
炔诺孕酮和炔雌醇	G
左炔诺孕酮和炔雌醇	G
甲羟孕酮和炔雌醇	G
去氧孕烯和炔雌醇	G
孕二烯酮和炔雌醇	G
诺孕酯和炔雌醇	G
屈螺酮和炔雌醇	G
甲基孕酮和炔雌醇	G
诺美孕酮和炔雌醇	G
氯地孕酮和炔雌醇	G
甲地孕酮和炔雌醇	G
去氧孕烯和雌激素	G
地诺孕素和雌二醇	G
炔诺酮	G
利奈孕酮	G
左炔诺孕酮	G
奎孕醇	G
甲地孕酮	G
甲羟孕酮（安宫黄体酮）	G
诺孕烯酮	G
依托孕烯	G
去氧孕烯	G
氟甲睾酮（氟羟甲基睾丸素）	G
甲睾酮	G
睾酮	G
美睾酮	G
雄诺龙（二氢睾酮，雄烯醇酮）	G
炔雌醇	G
雌二醇	G
雌三醇	G
氯烯雌醚（三茴香基氯乙烯）	G
雌酮	G
普罗雌烯	G
雌二醇，复方	G
组合雌激素	G
己二烯雌酚（双烯雌酚）	G
己烯雌酚	G
美沙雌酸	G
莫克雌醇	G
替勃龙	G
孕诺酮	G
羟孕酮（羟黄体酮）	G
孕酮（黄体酮）	G
地屈孕酮（去氢孕酮，脱氧孕酮）	G
美屈孕酮	G
诺美孕酮	G
地美孕酮	G
氯地孕酮	G
普美孕酮	G
烯丙雌醇（烯丙雌烯醇）	G
利奈孕酮（炔雌烯醇）	G
炔孕酮（羟脱水孕酮）	G
炔诺醇	G
甲诺酮	G
甲睾酮和雌激素	G
睾酮和雌激素	G
普拉睾酮和雌激素	G
炔诺酮和雌激素	G
羟孕酮和雌激素	G
炔孕酮和雌激素	G
黄体酮和雌激素	G
甲诺睾酮和雌激素	G
炔诺醇和雌激素	G
利奈孕酮和雌激素	G
异炔诺酮和雌激素	G
炔诺孕酮和雌激素	G
左炔诺孕酮和雌激素	G
甲羟孕酮和雌激素	G
诺孕酯和雌激素	G
地屈孕酮和雌激素	G
地诺孕素和雌激素	G
曲美孕酮和雌激素	G
屈螺酮和雌激素	G
氯地孕酮和雌激素	G
美屈孕酮和雌激素	G
绒膜促性腺激素	G
人绝经促性腺激素	G
血清促性腺激素	G
尿促滤泡素	G
促滤泡素α	G
促滤泡素β	G
促黄体素α	G
绒膜促性腺激素α	G
环芬尼（环醋环烷）	G
氯米芬	G
表美雌醇	G
环丙孕酮	G
环丙孕酮和雌激素	G
达那唑（炔睾醇，炔羟雄烯异唑）	G
孕三烯酮	G
米非司酮	G
埃拉片	G
雷洛昔芬	G
依美铵	G
黄酮哌酯	G
美拉肼	G
奥昔布宁	G
特罗地林	G
丙哌维林	G
托特罗定	G
索非那新	G
曲司铵	G
达非那新	G
弗斯特罗定	G
米拉贝隆	G
罂粟碱（鸦片全碱）	G
西地那非	G
育亨宾	G
酚妥拉明（芬托拉明，吩妥胺）	G
莫西赛利（百里胺）	G
阿扑吗啡	G
他达那非（西力士）	G
伐地那非（瓦地那非）	G
罂粟碱，复方	G
醋羟胺酸	G
非那吡啶	G
琥珀酰亚胺	G
水杨酸苯酯	G
二甲亚砜	G
达泊西汀	G
阿夫唑嗪	G
坦洛新（坦素罗辛）	G
特拉唑嗪	G
西罗多辛（西洛多辛、西洛辛）	G
阿夫唑嗪和非那雄胺（非那甾胺）	G
坦洛新（坦素罗辛）和度他雄胺（度泰利特、度泰甾胺）	G
坦索罗辛/索非那新	G
度他雄胺（度泰利特、度泰甾胺）	G
非洲刺李	G
锯棕果	G
促皮质素	H
替可克肽	H
促甲状腺素	H
生长激素	H
人蛋氨生长素	H
美卡舍明	H
舍莫瑞林	H
美卡舍明-林菲培	H
派格索曼	H
加压素	H
去氨加压素	H
苯赖加压素	H
特利加压素	H
鸟氨加压素	H
精氨加压素	H
去氨缩宫素	H
缩宫素	H
卡贝缩宫素	H
戈那瑞林	H
那法瑞林	H
生长抑素	H
奥曲肽	H
兰瑞肽	H
伐普肽	H
帕斯瑞肽	H
加尼瑞克	H
西曲瑞克	H
醛甾酮	H
氟氢可的松	H
去氧皮质酮	H
甲泼尼龙	H
帕拉米松（对氟米松）	H
泼尼松	H
可的松	H
泼尼立定	H
利美索龙	H
地夫可特	H
氯泼尼醇	H
甲泼尼松	H
可的伐唑	H
甲泼尼龙，复方	H
曲洛司坦	H
左甲状腺素钠	H
碘塞罗宁钠	H
左甲状腺素和碘塞罗宁的复方	H
甲状腺体制剂	H
甲硫氧嘧啶（甲硫尿嘧啶）	H
丙硫氧嘧啶（丙硫尿嘧啶）	H
苄硫氧嘧啶（苄硫尿嘧啶）	H
卡比马唑	H
甲巯咪唑（他巴唑）	H
甲巯咪唑，复方	H
高氯酸钾	H
二碘酪氨酸	H
二溴酪氨酸	H
高血糖素	H
甲状旁腺提取物	H
特立帕肽	H
甲状旁腺激素	H
合成鲑降钙素	H
天然猪降钙素	H
合成人降钙素	H
依降钙素	H
西那卡塞	H
帕立骨化醇	H
度骨化醇	H
赖甲环素	J
美他环素	J
罗利环素	J
青哌环素	J
氯莫环素	J
替加环素	J
四环素的复方	J
土霉素，复方	J
甲砜霉素	J
甲砜霉素，复方	J
氨苄西林	J
匹氨西林	J
羧苄西林	J
阿莫西林	J
卡茚西林	J
巴氨西林	J
依匹西林	J
匹美西林	J
阿洛西林	J
美洛西林	J
美西林	J
哌拉西林	J
替卡西林	J
美坦西林	J
酞氨西林	J
磺苄西林	J
替莫西林	J
海他西林	J
氨苄西林，复方	J
青霉素G	J
青霉素V	J
异丙西林	J
阿度西林（叠氮西林）	J
非奈西林	J
培那西林	J
氯甲西林	J
苄星青霉素G	J
普鲁卡因青霉素	J
苄星青霉素V	J
双氯西林	J
氯唑西林	J
甲氧西林	J
苯唑西林	J
氟氯西林	J
萘夫西林	J
舒巴坦	J
三唑巴坦（泰唑巴坦）	J
氨苄西林和酶抑制剂	J
阿莫西林和酶抑制剂	J
替卡西林和酶抑制剂	J
舒他西林（舒氨苄西林，氨苄青霉烷砜）	J
哌拉西林和酶抑制药	J
青霉素类复方	J
头孢氨苄（头孢力新，先锋霉素IV）	J
头孢噻啶（头孢娄利定，先锋霉素II）	J
头孢噻吩（头孢娄新，先锋霉素I）	J
头孢唑林（头孢菌素V，先锋霉素V）	J
头孢羟氨苄	J
头孢西酮	J
头孢曲秦	J
头孢匹林（先锋霉素VIII）	J
头孢拉定（先锋霉素IV，头孢环己烯，环己烯胺头孢菌素）	J
头孢乙腈（氰甲头孢菌素，头孢赛曲）	J
头孢沙定	J
头孢替唑（头孢去甲唑啉）	J
头孢西丁（美福仙，先锋美吩，头霉噻吩，头孢甲氧霉素）	J
头孢呋辛（头孢氨呋肟，呋肟头孢菌素）	J
头孢孟多（头孢羟唑）	J
头孢克洛（头孢克罗，头孢氯氨苄）	J
头孢替坦（头孢双硫唑甲氧）	J
头孢尼西（头孢羟苄磺唑）	J
头孢替安（头孢噻乙胺唑，噻乙胺唑头孢菌素）	J
氯碳头孢	J
头孢美唑	J
头孢丙烯	J
头孢雷特	J
头孢噻肟（头孢氨噻，头孢氨噻肟，先锋龙）	J
头孢他啶（头孢噻甲羧肟）	J
头孢磺啶（磺吡苄头孢菌素，头孢磺吡酮）	J
头孢曲松（头孢三嗪，头孢嗪克松，头孢氨噻三嗪）	J
头孢甲肟（头孢氨噻肟唑）	J
拉氧头孢	J
头孢唑肟（去甲噻肟头孢菌素，头孢甲噻肟，安保速灵，安普西林）	J
头孢克肟	J
头孢地秦	J
头孢他美	J
头孢匹胺（头孢吡四唑）	J
头孢哌酮	J
头孢泊肟	J
头孢布烯（头孢布坦, 先力腾, 头孢噻腾）	J
头孢地尼	J
头孢托仑	J
头孢卡品	J
头孢曲松，复方	J
头孢哌酮,复方	J
头孢吡肟（头孢匹美）	J
头孢匹罗	J
头孢唑兰	J
氨曲南（氨噻羧单胺菌素，噻肟单酰胺菌素）	J
美罗培南	J
厄他培南	J
多尼培南	J
比阿培南	J
亚胺培南和酶抑制药	J
帕尼培南和倍他米隆	J
头孢比洛酯	J
法罗培南	J
甲氧苄啶	J
溴莫普林	J
艾拉普林	J
磺胺索嘧啶	J
磺胺二甲嘧啶	J
磺胺吡啶	J
磺胺异噁唑	J
磺胺硫脲	J
磺胺甲噁唑	J
磺胺嘧啶	J
磺胺噁唑	J
磺胺地索辛	J
磺胺林	J
磺胺托嘧啶	J
磺胺对甲氧嘧啶	J
磺胺甲氧嗪	J
磺胺培林	J
磺胺苯吡唑	J
磺胺马宗	J
磺胺甲噁唑和甲氧苄啶	J
磺胺嘧啶和甲氧苄啶	J
磺胺美曲和甲氧苄啶	J
磺胺噁唑和甲氧苄啶	J
磺胺二甲嘧啶和甲氧苄啶	J
磺胺嘧啶和四氧普林	J
磺胺甲嘧啶和甲氧苄啶	J
螺旋霉素	J
麦迪霉素	J
竹桃霉素	J
罗红霉素	J
交沙霉素	J
醋竹桃霉素	J
克拉霉素	J
阿奇霉素	J
妙卡霉素	J
罗他霉素	J
地红霉素	J
氟红霉素	J
特利霉素	J
林可霉素	J
普那霉素	J
奎奴普汀（达福普汀）	J
链双霉素	J
妥布霉素	J
奈替米星	J
西索米星（紫苏霉素，西索霉素，西梭霉素）	J
地贝卡星	J
核糖霉素	J
异帕米星	J
阿贝卡星	J
氧氟沙星	J
环丙沙星	J
培氟沙星	J
依诺沙星（氟啶酸，氟哌酸，力醇罗）	J
替马沙星	J
诺氟沙星	J
洛美沙星	J
氟罗沙星	J
司帕沙星	J
芦氟沙星	J
格帕沙星	J
左氧氟沙星	J
曲伐沙星	J
莫西沙星	J
吉米沙星	J
加替沙星	J
普卢利沙星	J
帕珠沙星	J
加雷沙星	J
罗索沙星	J
萘啶酸	J
吡咯米酸（吡咯酸）	J
吡哌酸	J
奥索利酸（噁喹酸）	J
西诺沙星	J
氟甲喹	J
青霉素类与其它抗菌药的复方	J
磺胺类与其它抗菌药（甲氧苄啶除外）的复方	J
头孢呋辛与其它抗菌药的复方	J
螺旋霉素，与其它抗菌药的复方	J
左氧氟沙星联合其他抗菌药	J
替考拉宁	J
泰拉万星	J
达巴万星	J
奥利万星	J
替硝唑（硝砜咪唑）	J
呋喃妥因	J
硝呋妥因醇	J
磷霉素	J
希波酚（异冰片二甲酚）	J
氯福克酚	J